R 1280 720

NO ./xpm/grey.xpm
SO ./xpm/brick.xpm
WE ./xpm/wood.xpm
EA ./xpm/blue.xpm
S ./xpm/barrel.xpm

C 125,175,250
F 50,50,50

11111111111111111111111111111
11111111101100000111000000001
10000000001100000111011111111
11110111111111011100000010001
11110111111111011101010010001
11100000110101011100000010001
10000000000000001100000000W01
11100000000000001101000000001
11000000000101111101111000111
11110110001100000001111010001
11111111111111111111111111111